{
	100705297,
	100705298,
	100705299,
	100705300,
	100705301,
	100705302,
	100705303,
	100705304,
	100705305,
	100705306,
}